Level 1
w = wall, p = platform, f = false tile

01
02
03wwffffffffffffffffffffffffffffww
04ww                            ww
05ww                            ww
06ww                            ww
07ww                            ww
08ww                            ww
09ww                            ww
10ww                            ww
11ww                            ww
12ww                            ww
13wwpp   pppppppppppppppppp   ppww
14ww                            ww
15ww                            ww
16ww                            ww
17ww                            ww
18wwpp   pppppppppppppppppp   ppww
19ww                            ww
20ww                            ww
21ww                            ww
22ww                            ww
23wwpp   pppppppppppppppppp   ppww
24ww                            ww
25ww                            ww
26ww                            ww
27ww                            ww
28wwppppppppppppppppppppppppppppww
:
ZenChan: 64, 48
ZenChan: 128, 48
ZenChan: 192, 48
Maita: 128, 96
-

Level 2
w = wall, p = platform, f = false tile

01
02
03wwffffffffffffffffffffffffffffww
04ww                            ww
05ww                            ww
06ww                            ww
07ww                            ww
08ww           pppppp           ww
09ww                            ww
10ww                            ww
11ww                            ww
12ww                            ww
13ww        ppppp  ppppp        ww
14ww                            ww
15ww                            ww
16ww                            ww
17ww                            ww
18ww     pppppppppppppppppp     ww
19ww                            ww
20ww                            ww
21ww                            ww
22ww                            ww
23ww  ppppppp  pppppp  ppppppp  ww
24ww                            ww
25ww                            ww
26ww                            ww
27ww                            ww
28wwppppppppppppppppppppppppppppww
:
ZenChan: 64, 48
ZenChan: 128, 48
ZenChan: 192, 48
Maita: 128, 96
-

Level 3
w = wall, p = platform, f = false tile

01
02
03wwfffffff    ffffff    fffffffww
04ww                            ww
05ww                            ww
06ww                            ww
07ww                            ww
08ww   pppppppp      pppppppp   ww
09ww   w                    w   ww
10ww   w                    w   ww
11ww   w                    w   ww
12ww   w                    w   ww
13ww   wpppppppp    ppppppppw   ww
14ww   w                    w   ww
15ww   w                    w   ww
16ww   w                    w   ww
17ww   w                    w   ww
18ww   wppppppppp  pppppppppw   ww
19ww                            ww
20ww                            ww
21ww                            ww
22ww                            ww
23wwppppp  ppp        ppp  pppppww
24ww                            ww
25ww                            ww
26ww                            ww
27ww                            ww
28wwppppppp    pppppp    pppppppww
:
ZenChan: 64, 48
ZenChan: 128, 48
ZenChan: 192, 48
Maita: 128, 96
-